000000000000000000000000000
0GGGGTGGGGGGGWGGGGGGGGGTGG0
0GTTTTGGGTGGGWGGGGGGGGGTGG0
0GTGGTGGGTGGGWGGGGGGGGGGGG0
0GTGGTTTTTGGGGGGGTGGGGGGGG0
0GTGGGGGGGGGGGGGGTGGTTGGGG0
0GTGGGGGGGGGGGGGGTGGTTGGTT0
0GTGGGGGGGGGGWGGGTGGGGGGGG0
0GTTTTTTTTGGGWGGGGGGGGGGGG0
0GGGGGGTGGGGGWGGGGGGGGGGGG0
0GGGGGGTGGGGGWGGGTTGGGGGGG0
0GGGGGGGGGGGGWGGGGGGGGGGGG0
0WWWWWWWWWWWWWGGWWWGGTTTTT0
0GGGGGGGGGGTGGGGGGWGGGGGGG0
0GGGGGGGGGGTGGGGGGWGGGGGGG0
0GGWWGGGGGGTGGGGGGWGGGGTGG0
0GGWGGGGGGGGGGGGGGWGGGGTGG0
0GGWGGGGGGGGGGGGGGWWWGGTGG0
0GGWGGGGGGGGGGGGGGGGGGGTGG0
0GGGGGWWWGGGGGGGGGGGGGGTGG0
0GGGGGGGWGGWWWTGGGGGGGGGGG0
0GGGGGGGWGGWGGTGGTTTTTTGGT0
0GGGGGGGWWWWGGTGGGGTGGGGGG0
0GGGGGGGGGGGGGTGGGGTGGGGGG0
0GGGGGTGGGGGGGTGGGGTGTTTTT0
0GGGGGTGGGGGGGTGGGGTGGGGGG0
000000000000000000000000000
